CREDITS.txt - 2013-07-23
------------------------

Few projects are completed by one person, and CUPS is no exception.  We'd
like to thank the following individuals for their contributions:

    Nathaniel Barbour              - Lots of testing and feedback.
    N. Becker                      - setsid().
    Philippe Combes                - French localization and buttons script.
    Jean-Eric Cuendet              - GhostScript filters for CUPS.
    Van Dang                       - HTTP and IPP policeman.
    L. Peter Deutsch               - MD5 code.
    Dr. ZP Han                     - setgid()/setuid().
    Guy Harris                     - *BSD shared libraries and lots of other
                                     fixes.
    Bjoern Jacke                   - I18N stuff.
    Wang Jian                      - CUPS RPM corrections.
    Roderick Johnstone             - Beta tester of the millenium.
    Till Kamppeter                 - Bug fixes, beta testing, evangelism.
    Iñaki Larrañaga                - Basque localization.
    Kenshi Muto                    - Japanese localization, patches, and
                                     testing.
    Tomohiro Kato                  - Japanese localization.
    Kiko                           - Bug fixes.
    Sergey V. Kovalyov             - ESP Print Pro and CUPS beta tester.
    Marek Laane                    - Estonian translation.
    Mark Lawrence                  - Microsoft interoperability testing.
    Jeff Licquia                   - Bug fixes, beta testing, evangelism.
    Jason McMullan                 - Original CUPS RPM distributions.
    Àngel Mompó                    - Catalan localization.
    Wes Morgan                     - *BSD fixes.
    Daniel Nylander                - Swedish localization.
    Niklas 'Nille' Åkerström       - Swedish localization.
    Naruiko Ogasawara              - Japanese localization.
    Giulio Orsero                  - Bug fixes and testing.
    Michal Osowiecki               - Polish localization.
    Citra Paska                    - Indonesian localization.
    Kurt Pfeifle                   - Bug fixes, beta testing, evangelism.
    Vincenzo Reale                 - Italian localization.
    Petter Reinholdtsen            - HP-UX compiler stuff.
    Juan Pablo González Riopedre   - Spanish localization.
    Giovanni Scafora               - Italian localization.
    Opher Shachar                  - Hebrew localization.
    Stuart Stevens                 - HP JetDirect IPP information.
    Andrea Suatoni                 - IRIX desktop integration and testing.
    Teppo Turliainen               - Finnish localization.
    Tim Waugh                      - Lots of patches, testing, and Linux
                                     integration.
    Yugami                         - LDAP browsing support.

If I've missed someone, please let me know by sending an email to
"msweet@apple.com".
